WE assets/wood.png
SO assets/grey.png
EA assets/brick.png
NO assets/blue.png

F 133,117,92
C 82,39,16

111111111111111111        
100000000010000101
1000E00000E0001000111
1000001010100000011
10000000001100000111111
10000000110001000000111111
 1111010101110010000000001
    100000001011100011111
1111000001000001000111
11000001000001111111
11110000000000000101
111111111111010101111
11111100000000011
10000000111111111
111111111






