WE assets/wood.png
SO assets/grey.png
EA assets/brick.png
NO assets/blue.png

F 220,100,0
C 225,30,0

11111111111111111111111
10000101000010000000001
10000101001010000000001
10000001001010000000001
10000101001010000000001
11111101111010000000001
100E0000000000000000001
10000000000000000000001
10000000000000000000001
10000000000000000000001
11111111111111111111111