WE assets/wolftextures1.png
SO assets/wolftextures2.png
EA assets/wolftextures.png
NO assets/wolftextures3.png

F 255,0,0
C 255,255,0


1111111111
10001010101
10010001011
11000001011
1001W001011
1111111111