WE assets/wolftextures1.xpm42
SO assets/wall_1.xpm42
EA assets/wall_2.xpm42
NO assets/north.xpm42

F 220,100,0
C 225,30,0

        
        1111111111111111111111111
        1000000000110000000000001
        1011000001110000000000001
        1001000000S00000000000001
111111111011000001010000000000001
100000000011000001110111111111111
11110111111111011100000010001
11110111111111011101010010001
110000001101010101100000010001
10000000000000001100000010001
10000000000000001101010010001 
1100000111010101111101111000111
11110111 1110101 101111010001
11111111 1111111 111111111111