WE assets/wolftextures1.png
SO assets/wolftextures2.png
EA assets/wolftextures.png
NO assets/wolftextures3.png

F 255,0,0
C 255,255,0


1111111111111111111111111111111111111111111111
1000100010001000100010000000000100010001000101
1000000000000000000000000000000000000000000001
1000000000000000000000000000000000000000000001
1000000000000000000000000000000000000000000001
1100000000000000000000000000000000000000000001
1W00000000000000000000000000000000000000000001
1111111111111111111111111111111111111111111111