WE assets/wolftextures1.png
SO assets/wolftextures2.png
EA assets/wolftextures.png
NO assets/wolftextures3.png

F 255,0,0
C 255,255,0


1111111
1000101
1010101
1010101
1W10001
1111111