WE assets/wood.png
SO assets/grey.png
EA assets/brick.png
NO assets/blue.png

F 255,0,0
C 255,255,0

11111
10001
10001
10001
10N01
11111