WE assets/wolftextures1.png
SO assets/wolftextures2.png
EA assets/wolftextures.png
NO assets/wolftextures3.png

F 133,117,92
C 82,39,16


111111
    10W101
101S01
    101E01
1100N1
    111111
