WE assets/wolftextures1.png
SO assets/wolftextures2.png
EA assets/wolftextures.png
NO assets/wolftextures3.png

F 255,0,0
C 255,255,0


11111111111111
10001000010000101
100100010000011
10001000001000011
1000000E0001011
100000100000001
111111111111111