WE assets/wood.png
SO assets/grey.png
EA assets/brick.png
NO assets/blue.png

F 133,117,92
C 82,39,16

1111111111111111111111111111111111111111111111111111111111111111111111111
1000100000000000000010000000000000001000000000001000000000000000000010001
1000110111111111100010001111100011111111100011111101111111011111100010001
1000000000000000100000001000100000000000100000000000100010001000000010001
1111111110001000111111111101111111111000111110001000100010001111111110001
1000000010001000000000000000100000000000100010001000100010000000000010001
1000100011111111111110001000100011111111100011111000110111111111100010001
1000100000000000000010001000100000001000000000001000000000001000000010001
1000111111111111100011111000111110001000111111011111111110001000111110001
1000000000001000000010001000000010001000000010000000000010001000000000001
1000111110001111100010001111100010001111111110001000100010001111111111111
1000000010000000100010001000000010000000100000001000100010000000100000001
1111111111111000100011011000111111111000100011111000100011111000111110001
1000000000001000100000000000100000001000100000001000100000001000000000001
1000111110001000111111111000111110001000111110001111100011111111111110001
1000100000001000000000001000000000001000000010001000100000000000000010001
1000100011111111100010001111100011111111100010001101111111111111100010001
1000100000000000100010001000100010000000000010000000000000000000100000001
1000111111111000100010001000111110001111111110001111111111011101111111111
10N0100000001000100010000000000010000000000010001000000010000000000000001
1000100011111101111111011111100011111111110111111000100011111111110110001
1000100000000000000000001000000000001000000000000000100000000000000010001
1111111111111111111111111111111111111111111111111111111111111111111111111