WE assets/wood.png
SO assets/grey.png
EA assets/brick.png
NO assets/blue.png

F 200,200,200
C 255,00,0

1111
1N01
1111