WE assets/wood.png
SO assets/grey.png
EA assets/brick.png
NO assets/blue.png

F 200,200,200
C 255,00,0

11111
10001
10001
10001
11111







