WE assets/wolftextures1.xpm
SO assets/wall_1.xpm
EA assets/wall_2.xpm
NO assets/north.xpm

F 255,0,0
C 255,255,0


111111111
100110001
110000111
110000111
100111101
100000001
100000001
101101101
1010E000101
111111111