WE assets/wolftextures1.xpm
SO assets/wolftextures2.xpm
EA assets/wolftextures1.xpm
NO assets/wolftextures1.xpm

F 255,0,0
C 255,255,0


111111111
100000001
100000001
100000001
100000001
100000001
100000001
100000001
100000001
100000001
100000001
100000001
100000001
100000001
100000001
100000001
100000001
100000001
1000N0001
111111111